{
	"mapdata": [
		["-", "-", "-", "-", "-", "-", "-", "-", "-", "-"],
		["-", "-", "-", "-", "-", "-", "-", "-", "-", "-"],
		["-", "#", "#", "#", "#", "#", "#", "#", "#", "-"],
		["-", "#", ",", ",", "#", "I", ",", ",", "#", "-"],
		["-", "#", "P", "B", "I", ",", ",", ",", "#", "-"],
		["-", "#", ",", ",", "B", "#", ",", "#", "#", "-"],
		["-", "#", "#", "#", ",", ",", ",", "#", "-", "-"],
		["-", "-", "-", "#", "#", "#", "#", "#", "-", "-"],
		["-", "-", "-", "-", "-", "-", "-", "-", "-", "-"],
		["-", "-", "-", "-", "-", "-", "-", "-", "-", "-"]
	],
	"solution": [
    ]

}
