{
    "mapdata": [
        ["-", "-", "-", "-", "-", "-", "-", "-", "-", "-"],
        ["-", "-", "-", "-", "-", "-", "-", "-", "-", "-"],
        ["-", "-", "-", "-", "#", "#", "#", "-", "-", "-"],
        ["-", "-", "-", "-", "#", "I", "#", "-", "-", "-"],
        ["-", "-", "-", "-", "#", ",", "#", "#", "-", "-"],
        ["-", "-", "#", "#", "#", "B", ",", "#", "-", "-"],
        ["-", "-", "#", "I", ",", "B", "P", "#", "-", "-"],
        ["-", "-", "#", "#", "#", "#", "#", "#", "-", "-"],
        ["-", "-", "-", "-", "-", "-", "-", "-", "-", "-"],
        ["-", "-", "-", "-", "-", "-", "-", "-", "-", "-"]
    ],
    "solution": [
        {
          "mapdata": [
            ["-", "-", "-", "-", "-", "-", "-", "-", "-", "-"],
            ["-", "-", "-", "-", "-", "-", "-", "-", "-", "-"],
            ["-", "-", "-", "-", "#", "#", "#", "-", "-", "-"],
            ["-", "-", "-", "-", "#", "I", "#", "-", "-", "-"],
            ["-", "-", "-", "-", "#", ",", "#", "#", "-", "-"],
            ["-", "-", "#", "#", "#", "B", ",", "#", "-", "-"],
            ["-", "-", "#", "I", "B", "P", ",", "#", "-", "-"],
            ["-", "-", "#", "#", "#", "#", "#", "#", "-", "-"],
            ["-", "-", "-", "-", "-", "-", "-", "-", "-", "-"],
            ["-", "-", "-", "-", "-", "-", "-", "-", "-", "-"]
          ],
          "direction": "left"
        },
        {
          "mapdata": [
            ["-", "-", "-", "-", "-", "-", "-", "-", "-", "-"],
            ["-", "-", "-", "-", "-", "-", "-", "-", "-", "-"],
            ["-", "-", "-", "-", "#", "#", "#", "-", "-", "-"],
            ["-", "-", "-", "-", "#", "I", "#", "-", "-", "-"],
            ["-", "-", "-", "-", "#", ",", "#", "#", "-", "-"],
            ["-", "-", "#", "#", "#", "B", ",", "#", "-", "-"],
            ["-", "-", "#", "B", "P", ",", ",", "#", "-", "-"],
            ["-", "-", "#", "#", "#", "#", "#", "#", "-", "-"],
            ["-", "-", "-", "-", "-", "-", "-", "-", "-", "-"],
            ["-", "-", "-", "-", "-", "-", "-", "-", "-", "-"]
          ],
          "direction": "left"
        },
        {
          "mapdata": [
            ["-", "-", "-", "-", "-", "-", "-", "-", "-", "-"],
            ["-", "-", "-", "-", "-", "-", "-", "-", "-", "-"],
            ["-", "-", "-", "-", "#", "#", "#", "-", "-", "-"],
            ["-", "-", "-", "-", "#", "I", "#", "-", "-", "-"],
            ["-", "-", "-", "-", "#", ",", "#", "#", "-", "-"],
            ["-", "-", "#", "#", "#", "B", ",", "#", "-", "-"],
            ["-", "-", "#", "B", ",", "P", ",", "#", "-", "-"],
            ["-", "-", "#", "#", "#", "#", "#", "#", "-", "-"],
            ["-", "-", "-", "-", "-", "-", "-", "-", "-", "-"],
            ["-", "-", "-", "-", "-", "-", "-", "-", "-", "-"]
          ],
          "direction": "right"
        },
        {
          "mapdata": [
            ["-", "-", "-", "-", "-", "-", "-", "-", "-", "-"],
            ["-", "-", "-", "-", "-", "-", "-", "-", "-", "-"],
            ["-", "-", "-", "-", "#", "#", "#", "-", "-", "-"],
            ["-", "-", "-", "-", "#", "I", "#", "-", "-", "-"],
            ["-", "-", "-", "-", "#", "B", "#", "#", "-", "-"],
            ["-", "-", "#", "#", "#", "P", ",", "#", "-", "-"],
            ["-", "-", "#", "B", ",", ",", ",", "#", "-", "-"],
            ["-", "-", "#", "#", "#", "#", "#", "#", "-", "-"],
            ["-", "-", "-", "-", "-", "-", "-", "-", "-", "-"],
            ["-", "-", "-", "-", "-", "-", "-", "-", "-", "-"]
          ],
          "direction": "up"
        },
        {
          "mapdata": [
            ["-", "-", "-", "-", "-", "-", "-", "-", "-", "-"],
            ["-", "-", "-", "-", "-", "-", "-", "-", "-", "-"],
            ["-", "-", "-", "-", "#", "#", "#", "-", "-", "-"],
            ["-", "-", "-", "-", "#", "B", "#", "-", "-", "-"],
            ["-", "-", "-", "-", "#", "P", "#", "#", "-", "-"],
            ["-", "-", "#", "#", "#", ",", ",", "#", "-", "-"],
            ["-", "-", "#", "B", ",", ",", ",", "#", "-", "-"],
            ["-", "-", "#", "#", "#", "#", "#", "#", "-", "-"],
            ["-", "-", "-", "-", "-", "-", "-", "-", "-", "-"],
            ["-", "-", "-", "-", "-", "-", "-", "-", "-", "-"]
          ],
          "direction": "up"
        }
      ]
      
}
