{
	"mapdata": [
		["-", "-", "-", "-", "-", "-", "-", "-", "-", "-"],
		["-", "-", "-", "-", "-", "-", "#", "#", "#", "-"],
		["-", "-", "#", "#", "#", "#", "#", "I", "#", "-"],
		["-", "#", "#", "I", ",", ",", ",", ",", "#", "-"],
		["-", "#", ",", "B", "#", "B", ",", ",", "#", "-"],
		["-", "#", ",", ",", ",", ",", "#", "P", "#", "-"],
		["-", "#", "#", "#", ",", ",", ",", "#", "#", "-"],
		["-", "-", "-", "#", ",", ",", ",", "#", "-", "-"],
		["-", "-", "-", "#", "#", "#", "#", "#", "-", "-"],
		["-", "-", "-", "-", "-", "-", "-", "-", "-", "-"]
	],
	"solution": [
    ]

}
