{
	"mapdata": [
		["-", "-", "-", "-", "-", "-", "-", "-", "-", "-"],
		["-", "-", "-", "-", "-", "-", "-", "-", "-", "-"],
		["-", "#", "#", "#", "#", "#", "#", "#", "-", "-"],
		["-", "#", ",", ",", ",", "I", ",", "#", "#", "-"],
		["-", "#", ",", ",", "B", "B", ",", ",", "#", "-"],
		["-", "#", "P", ",", "#", ",", ",", ",", "#", "-"],
		["-", "#", "#", "#", "#", "#", ",", "I", "#", "-"],
		["-", "-", "-", "-", "-", "#", "#", "#", "#", "-"],
		["-", "-", "-", "-", "-", "-", "-", "-", "-", "-"],
		["-", "-", "-", "-", "-", "-", "-", "-", "-", "-"]
	],
	"solution": [
    ]

}
