{
	"mapdata": [
		["-", "-", "-", "-", "-", "-", "-", "-", "-", "-"],
		["-", "-", "-", "-", "-", "-", "#", "#", "#", "-"],
		["-", "#", "#", "#", "#", "#", "#", "I", "#", "-"],
		["-", "#", ",", ",", ",", "B", "I", ",", "#", "-"],
		["-", "#", ",", ",", "B", "#", ",", "P", "#", "-"],
		["-", "#", "#", "#", ",", "#", "#", ",", "#", "-"],
		["-", "-", "-", "#", ",", ",", ",", ",", "#", "-"],
		["-", "-", "-", "#", "#", "#", "#", "#", "#", "-"],
		["-", "-", "-", "-", "-", "-", "-", "-", "-", "-"],
		["-", "-", "-", "-", "-", "-", "-", "-", "-", "-"]
	],
	"solution": [
    ]

}
