{
	"mapdata": [
		["-", "-", "-", "-", "-", "-", "-", "-", "-", "-"],
		["-", "-", "-", "-", "-", "-", "-", "-", "-", "-"],
		["-", "#", "#", "#", "#", "#", "#", "#", "-", "-"],
		["-", "#", "I", ",", ",", ",", "I", "#", "-", "-"],
		["-", "#", "#", "#", ",", "#", ",", "#", "-", "-"],
		["-", "#", ",", ",", ",", ",", "P", "#", "-", "-"],
		["-", "#", ",", "B", ",", ",", "B", "#", "-", "-"],
		["-", "#", "#", "#", "#", ",", ",", "#", "-", "-"],
		["-", "-", "-", "-", "#", "#", "#", "#", "-", "-"],
		["-", "-", "-", "-", "-", "-", "-", "-", "-", "-"]
	],
	"solution": [
    ]

}
