{
	"mapdata": [
		["-", "-", "-", "-", "-", "-", "-", "-", "-", "-"],
		["-", "-", "-", "#", "#", "#", "#", "#", "#", "-"],
		["-", "#", "#", "#", ",", "I", "I", "P", "#", "-"],
		["-", "#", ",", ",", "B", "I", ",", ",", "#", "-"],
		["-", "#", ",", ",", "B", "#", ",", "#", "#", "-"],
		["-", "#", "#", ",", ",", "B", ",", ",", "#", "-"],
		["-", "-", "#", ",", ",", "#", ",", ",", "#", "-"],
		["-", "-", "#", "#", "#", "#", "#", "#", "#", "-"],
		["-", "-", "-", "-", "-", "-", "-", "-", "-", "-"],
		["-", "-", "-", "-", "-", "-", "-", "-", "-", "-"]
	],
	"solution": [
    ]

}
