{
	"mapdata": [
		["-", "-", "-", "-", "-", "-", "-", "-", "-", "-"],
		["-", "-", "-", "-", "#", "#", "#", "#", "-", "-"],
		["-", "-", "#", "#", "#", "I", "I", "#", "-", "-"],
		["-", "-", "#", ",", "B", "B", ",", "#", "-", "-"],
		["-", "-", "#", ",", "I", ",", "P", "#", "-", "-"],
		["-", "-", "#", "#", "#", ",", "B", "#", "-", "-"],
		["-", "-", "-", "-", "#", ",", ",", "#", "-", "-"],
		["-", "-", "-", "-", "#", ",", ",", "#", "-", "-"],
		["-", "-", "-", "-", "#", ",", ",", "#", "-", "-"],
		["-", "-", "-", "-", "#", "#", "#", "#", "-", "-"]
	],
	"solution": [
    ]

}
