{
    "mapdata": [
        ["-", "-", "-", "-", "-", "-", "-", "-", "-", "-"],
        ["-", "-", "-", "-", "-", "-", "-", "-", "-", "-"],
        ["-", "#", "#", "#", "#", "#", "#", "#", "#", "-"],
        ["-", "#", "I", "I", "P", ",", ",", "I", "#", "-"],
        ["-", "#", "#", "#", "#", "B", "#", "B", "#", "-"],
        ["-", "-", "-", "#", "#", ",", "B", ",", "#", "-"],
        ["-", "-", "-", "#", ",", ",", ",", ",", "#", "-"],
        ["-", "-", "-", "#", ",", ",", ",", ",", "#", "-"],
        ["-", "-", "-", "#", "#", "#", "#", "#", "#", "-"],
        ["-", "-", "-", "-", "-", "-", "-", "-", "-", "-"]
    ],
    "solution": [
    ]
}
