{
	"mapdata": [
		["-", "-", "-", "-", "-", "-", "-", "-", "-", "-"],
		["-", "-", "-", "#", "#", "#", "#", "#", "-", "-"],
		["-", "-", "-", "#", "I", "I", "I", "#", "-", "-"],
		["-", "-", "-", "#", "P", "B", ",", "#", "-", "-"],
		["-", "#", "#", "#", "#", "B", ",", "#", "#", "-"],
		["-", "#", ",", ",", ",", "B", ",", ",", "#", "-"],
		["-", "#", ",", ",", ",", ",", ",", ",", "#", "-"],
		["-", "#", "#", "#", "#", "#", "#", "#", "#", "-"],
		["-", "-", "-", "-", "-", "-", "-", "-", "-", "-"],
		["-", "-", "-", "-", "-", "-", "-", "-", "-", "-"]
	],
	"solution": [
    ]

}
