{
	"mapdata": [
		["-", "-", "-", "-", "-", "-", "-", "-", "-", "-"],
		["-", "-", "#", "#", "#", "#", "#", "#", "#", "-"],
		["-", "-", "#", "I", "B", ",", "P", ",", "#", "-"],
		["-", "#", "#", ",", "#", ",", "B", ",", "#", "-"],
		["-", "#", ",", "I", ",", "B", ",", "#", "#", "-"],
		["-", "#", "I", ",", ",", "#", ",", ",", "#", "-"],
		["-", "#", "#", "#", ",", ",", ",", ",", "#", "-"],
		["-", "-", "-", "#", "#", "#", "#", "#", "#", "-"],
		["-", "-", "-", "-", "-", "-", "-", "-", "-", "-"],
		["-", "-", "-", "-", "-", "-", "-", "-", "-", "-"]
	],
	"solution": [
    ]

}
