{
	"mapdata": [
		["-", "-", "-", "-", "#", "#", "#", "-", "-", "-"],
		["#", "#", "#", "#", "#", "I", "#", "-", "-", "-"],
		["#", ",", ",", ",", "#", ",", "#", "#", "-", "-"],
		["#", ",", "B", ",", ",", ",", "I", "#", "-", "-"],
		["#", "#", "#", ",", "#", ",", "#", "#", "-", "-"],
		["#", ",", ",", "I", "#", ",", "#", "#", "#", "#"],
		["#", ",", ",", "#", "#", ",", "B", ",", ",", "#"],
		["#", "#", "B", "#", "#", ",", "B", ",", "#", "#"],
		["-", "#", ",", ",", ",", "P", ",", ",", "I", "#"],
		["-", "#", "#", "#", "#", "#", "#", "#", "#", "#"]
	],
	"solution": [
    ]

}
