{
    "mapdata": [
        ["-", "-", "-", "-", "-", "-", "-", "-", "-", "-"],
        ["-", "-", "-", "-", "-", "-", "-", "-", "-", "-"],
        ["-", "-", "-", "-", "#", "#", "#", "-", "-", "-"],
        ["-", "-", "-", "#", "#", "I", "#", "#", "#", "-"],
        ["-", "-", "#", "#", ",", ",", ",", ",", "#", "-"],
        ["-", "#", "#", ",", "P", ",", ",", ",", "#", "-"],
        ["-", "#", ",", "B", ",", "#", ",", ",", "#", "-"],
        ["-", "#", ",", ",", ",", ",", ",", "#", "#", "-"],
        ["-", "#", "#", "#", "#", "#", "#", "#", "-", "-"],
        ["-", "-", "-", "-", "-", "-", "-", "-", "-", "-"]
    ],
    "solution": [
        {
            "mapdata": [
                ["-", "-", "-", "-", "-", "-", "-", "-", "-", "-"],
                ["-", "-", "-", "-", "-", "-", "-", "-", "-", "-"],
                ["-", "-", "-", "-", "#", "#", "#", "-", "-", "-"],
                ["-", "-", "-", "#", "#", "I", "#", "#", "#", "-"],
                ["-", "-", "#", "#", ",", ",", ",", ",", "#", "-"],
                ["-", "#", "#", ",", "P", ",", ",", ",", "#", "-"],
                ["-", "#", ",", "B", ",", "#", ",", ",", "#", "-"],
                ["-", "#", ",", ",", ",", ",", ",", "#", "#", "-"],
                ["-", "#", "#", "#", "#", "#", "#", "#", "-", "-"],
                ["-", "-", "-", "-", "-", "-", "-", "-", "-", "-"]
            ],
            "direction": "down"
        },
        {
            "mapdata": [
                ["-", "-", "-", "-", "-", "-", "-", "-", "-", "-"],
                ["-", "-", "-", "-", "-", "-", "-", "-", "-", "-"],
                ["-", "-", "-", "-", "#", "#", "#", "-", "-", "-"],
                ["-", "-", "-", "#", "#", "I", "#", "#", "#", "-"],
                ["-", "-", "#", "#", ",", ",", ",", ",", "#", "-"],
                ["-", "#", "#", ",", ",", ",", ",", ",", "#", "-"],
                ["-", "#", ",", "B", "P", "#", ",", ",", "#", "-"],
                ["-", "#", ",", ",", ",", ",", ",", "#", "#", "-"],
                ["-", "#", "#", "#", "#", "#", "#", "#", "-", "-"],
                ["-", "-", "-", "-", "-", "-", "-", "-", "-", "-"]
            ],
            "direction": "down"
        },
        {
            "mapdata": [
                ["-", "-", "-", "-", "-", "-", "-", "-", "-", "-"],
                ["-", "-", "-", "-", "-", "-", "-", "-", "-", "-"],
                ["-", "-", "-", "-", "#", "#", "#", "-", "-", "-"],
                ["-", "-", "-", "#", "#", "I", "#", "#", "#", "-"],
                ["-", "-", "#", "#", ",", ",", ",", ",", "#", "-"],
                ["-", "#", "#", ",", ",", ",", ",", ",", "#", "-"],
                ["-", "#", ",", "B", ",", "#", ",", ",", "#", "-"],
                ["-", "#", ",", ",", "P", ",", ",", "#", "#", "-"],
                ["-", "#", "#", "#", "#", "#", "#", "#", "-", "-"],
                ["-", "-", "-", "-", "-", "-", "-", "-", "-", "-"]
            ],
            "direction": "down"
        },
        {
            "mapdata": [
                ["-", "-", "-", "-", "-", "-", "-", "-", "-", "-"],
                ["-", "-", "-", "-", "-", "-", "-", "-", "-", "-"],
                ["-", "-", "-", "-", "#", "#", "#", "-", "-", "-"],
                ["-", "-", "-", "#", "#", "I", "#", "#", "#", "-"],
                ["-", "-", "#", "#", ",", ",", ",", ",", "#", "-"],
                ["-", "#", "#", ",", ",", ",", ",", ",", "#", "-"],
                ["-", "#", ",", "B", ",", "#", ",", ",", "#", "-"],
                ["-", "#", ",", "P", ",", ",", ",", "#", "#", "-"],
                ["-", "#", "#", "#", "#", "#", "#", "#", "-", "-"],
                ["-", "-", "-", "-", "-", "-", "-", "-", "-", "-"]
            ],
            "direction": "left"
        },
        {
            "mapdata": [
                ["-", "-", "-", "-", "-", "-", "-", "-", "-", "-"],
                ["-", "-", "-", "-", "-", "-", "-", "-", "-", "-"],
                ["-", "-", "-", "-", "#", "#", "#", "-", "-", "-"],
                ["-", "-", "-", "#", "#", "I", "#", "#", "#", "-"],
                ["-", "-", "#", "#", ",", ",", ",", ",", "#", "-"],
                ["-", "#", "#", ",", ",", ",", ",", ",", "#", "-"],
                ["-", "#", ",", "B", ",", "#", ",", ",", "#", "-"],
                ["-", "#", "P", ",", ",", ",", ",", "#", "#", "-"],
                ["-", "#", "#", "#", "#", "#", "#", "#", "-", "-"],
                ["-", "-", "-", "-", "-", "-", "-", "-", "-", "-"]
            ],
            "direction": "left"
        },
        {
            "mapdata": [
                ["-", "-", "-", "-", "-", "-", "-", "-", "-", "-"],
                ["-", "-", "-", "-", "-", "-", "-", "-", "-", "-"],
                ["-", "-", "-", "-", "#", "#", "#", "-", "-", "-"],
                ["-", "-", "-", "#", "#", "I", "#", "#", "#", "-"],
                ["-", "-", "#", "#", ",", ",", ",", ",", "#", "-"],
                ["-", "#", "#", ",", ",", ",", ",", ",", "#", "-"],
                ["-", "#", "P", "B", ",", "#", ",", ",", "#", "-"],
                ["-", "#", ",", ",", ",", ",", ",", "#", "#", "-"],
                ["-", "#", "#", "#", "#", "#", "#", "#", "-", "-"],
                ["-", "-", "-", "-", "-", "-", "-", "-", "-", "-"]
            ],
            "direction": "up"
        },
        {
            "mapdata": [
                ["-", "-", "-", "-", "-", "-", "-", "-", "-", "-"],
                ["-", "-", "-", "-", "-", "-", "-", "-", "-", "-"],
                ["-", "-", "-", "-", "#", "#", "#", "-", "-", "-"],
                ["-", "-", "-", "#", "#", "I", "#", "#", "#", "-"],
                ["-", "-", "#", "#", ",", ",", ",", ",", "#", "-"],
                ["-", "#", "#", ",", ",", ",", ",", ",", "#", "-"],
                ["-", "#", ",", "P", "B", "#", ",", ",", "#", "-"],
                ["-", "#", ",", ",", ",", ",", ",", "#", "#", "-"],
                ["-", "#", "#", "#", "#", "#", "#", "#", "-", "-"],
                ["-", "-", "-", "-", "-", "-", "-", "-", "-", "-"]
            ],
            "direction": "right"
        },
        {
            "mapdata": [
                ["-", "-", "-", "-", "-", "-", "-", "-", "-", "-"],
                ["-", "-", "-", "-", "-", "-", "-", "-", "-", "-"],
                ["-", "-", "-", "-", "#", "#", "#", "-", "-", "-"],
                ["-", "-", "-", "#", "#", "I", "#", "#", "#", "-"],
                ["-", "-", "#", "#", ",", ",", ",", ",", "#", "-"],
                ["-", "#", "#", ",", ",", ",", ",", ",", "#", "-"],
                ["-", "#", ",", ",", "B", "#", ",", ",", "#", "-"],
                ["-", "#", ",", "P", ",", ",", ",", "#", "#", "-"],
                ["-", "#", "#", "#", "#", "#", "#", "#", "-", "-"],
                ["-", "-", "-", "-", "-", "-", "-", "-", "-", "-"]
            ],
            "direction": "down"
        },
        {
            "mapdata": [
                ["-", "-", "-", "-", "-", "-", "-", "-", "-", "-"],
                ["-", "-", "-", "-", "-", "-", "-", "-", "-", "-"],
                ["-", "-", "-", "-", "#", "#", "#", "-", "-", "-"],
                ["-", "-", "-", "#", "#", "I", "#", "#", "#", "-"],
                ["-", "-", "#", "#", ",", ",", ",", ",", "#", "-"],
                ["-", "#", "#", ",", ",", ",", ",", ",", "#", "-"],
                ["-", "#", ",", ",", "B", "#", ",", ",", "#", "-"],
                ["-", "#", ",", ",", "P", ",", ",", "#", "#", "-"],
                ["-", "#", "#", "#", "#", "#", "#", "#", "-", "-"],
                ["-", "-", "-", "-", "-", "-", "-", "-", "-", "-"]
            ],
            "direction": "right"
        },
        {
            "mapdata": [
                ["-", "-", "-", "-", "-", "-", "-", "-", "-", "-"],
                ["-", "-", "-", "-", "-", "-", "-", "-", "-", "-"],
                ["-", "-", "-", "-", "#", "#", "#", "-", "-", "-"],
                ["-", "-", "-", "#", "#", "I", "#", "#", "#", "-"],
                ["-", "-", "#", "#", ",", ",", ",", ",", "#", "-"],
                ["-", "#", "#", ",", "B", ",", ",", ",", "#", "-"],
                ["-", "#", ",", ",", "P", "#", ",", ",", "#", "-"],
                ["-", "#", ",", ",", ",", ",", ",", "#", "#", "-"],
                ["-", "#", "#", "#", "#", "#", "#", "#", "-", "-"],
                ["-", "-", "-", "-", "-", "-", "-", "-", "-", "-"]
            ],
            "direction": "up"
        },
        {
            "mapdata": [
                ["-", "-", "-", "-", "-", "-", "-", "-", "-", "-"],
                ["-", "-", "-", "-", "-", "-", "-", "-", "-", "-"],
                ["-", "-", "-", "-", "#", "#", "#", "-", "-", "-"],
                ["-", "-", "-", "#", "#", "I", "#", "#", "#", "-"],
                ["-", "-", "#", "#", ",", ",", ",", ",", "#", "-"],
                ["-", "#", "#", ",", "B", ",", ",", ",", "#", "-"],
                ["-", "#", ",", "P", ",", "#", ",", ",", "#", "-"],
                ["-", "#", ",", ",", ",", ",", ",", "#", "#", "-"],
                ["-", "#", "#", "#", "#", "#", "#", "#", "-", "-"],
                ["-", "-", "-", "-", "-", "-", "-", "-", "-", "-"]
            ],
            "direction": "left"
        },
        {
            "mapdata": [
                ["-", "-", "-", "-", "-", "-", "-", "-", "-", "-"],
                ["-", "-", "-", "-", "-", "-", "-", "-", "-", "-"],
                ["-", "-", "-", "-", "#", "#", "#", "-", "-", "-"],
                ["-", "-", "-", "#", "#", "I", "#", "#", "#", "-"],
                ["-", "-", "#", "#", ",", ",", ",", ",", "#", "-"],
                ["-", "#", "#", "P", "B", ",", ",", ",", "#", "-"],
                ["-", "#", ",", ",", ",", "#", ",", ",", "#", "-"],
                ["-", "#", ",", ",", ",", ",", ",", "#", "#", "-"],
                ["-", "#", "#", "#", "#", "#", "#", "#", "-", "-"],
                ["-", "-", "-", "-", "-", "-", "-", "-", "-", "-"]
            ],
            "direction": "up"
        },
        {
            "mapdata": [
                ["-", "-", "-", "-", "-", "-", "-", "-", "-", "-"],
                ["-", "-", "-", "-", "-", "-", "-", "-", "-", "-"],
                ["-", "-", "-", "-", "#", "#", "#", "-", "-", "-"],
                ["-", "-", "-", "#", "#", "I", "#", "#", "#", "-"],
                ["-", "-", "#", "#", ",", ",", ",", ",", "#", "-"],
                ["-", "#", "#", ",", "P", "B", ",", ",", "#", "-"],
                ["-", "#", ",", ",", ",", "#", ",", ",", "#", "-"],
                ["-", "#", ",", ",", ",", ",", ",", "#", "#", "-"],
                ["-", "#", "#", "#", "#", "#", "#", "#", "-", "-"],
                ["-", "-", "-", "-", "-", "-", "-", "-", "-", "-"]
            ],
            "direction": "right"
        },
        {
            "mapdata": [
                ["-", "-", "-", "-", "-", "-", "-", "-", "-", "-"],
                ["-", "-", "-", "-", "-", "-", "-", "-", "-", "-"],
                ["-", "-", "-", "-", "#", "#", "#", "-", "-", "-"],
                ["-", "-", "-", "#", "#", "I", "#", "#", "#", "-"],
                ["-", "-", "#", "#", ",", ",", ",", ",", "#", "-"],
                ["-", "#", "#", ",", ",", "P", "B", ",", "#", "-"],
                ["-", "#", ",", ",", ",", "#", ",", ",", "#", "-"],
                ["-", "#", ",", ",", ",", ",", ",", "#", "#", "-"],
                ["-", "#", "#", "#", "#", "#", "#", "#", "-", "-"],
                ["-", "-", "-", "-", "-", "-", "-", "-", "-", "-"]
            ],
            "direction": "right"
        },
        {
            "mapdata": [
                ["-", "-", "-", "-", "-", "-", "-", "-", "-", "-"],
                ["-", "-", "-", "-", "-", "-", "-", "-", "-", "-"],
                ["-", "-", "-", "-", "#", "#", "#", "-", "-", "-"],
                ["-", "-", "-", "#", "#", "I", "#", "#", "#", "-"],
                ["-", "-", "#", "#", ",", "P", ",", ",", "#", "-"],
                ["-", "#", "#", ",", ",", ",", "B", ",", "#", "-"],
                ["-", "#", ",", ",", ",", "#", ",", ",", "#", "-"],
                ["-", "#", ",", ",", ",", ",", ",", "#", "#", "-"],
                ["-", "#", "#", "#", "#", "#", "#", "#", "-", "-"],
                ["-", "-", "-", "-", "-", "-", "-", "-", "-", "-"]
            ],
            "direction": "up"
        },
        {
            "mapdata": [
                ["-", "-", "-", "-", "-", "-", "-", "-", "-", "-"],
                ["-", "-", "-", "-", "-", "-", "-", "-", "-", "-"],
                ["-", "-", "-", "-", "#", "#", "#", "-", "-", "-"],
                ["-", "-", "-", "#", "#", "I", "#", "#", "#", "-"],
                ["-", "-", "#", "#", ",", ",", "P", ",", "#", "-"],
                ["-", "#", "#", ",", ",", ",", "B", ",", "#", "-"],
                ["-", "#", ",", ",", ",", "#", ",", ",", "#", "-"],
                ["-", "#", ",", ",", ",", ",", ",", "#", "#", "-"],
                ["-", "#", "#", "#", "#", "#", "#", "#", "-", "-"],
                ["-", "-", "-", "-", "-", "-", "-", "-", "-", "-"]
            ],
            "direction": "right"
        },
        {
            "mapdata": [
                ["-", "-", "-", "-", "-", "-", "-", "-", "-", "-"],
                ["-", "-", "-", "-", "-", "-", "-", "-", "-", "-"],
                ["-", "-", "-", "-", "#", "#", "#", "-", "-", "-"],
                ["-", "-", "-", "#", "#", "I", "#", "#", "#", "-"],
                ["-", "-", "#", "#", ",", ",", ",", "P", "#", "-"],
                ["-", "#", "#", ",", ",", ",", "B", ",", "#", "-"],
                ["-", "#", ",", ",", ",", "#", ",", ",", "#", "-"],
                ["-", "#", ",", ",", ",", ",", ",", "#", "#", "-"],
                ["-", "#", "#", "#", "#", "#", "#", "#", "-", "-"],
                ["-", "-", "-", "-", "-", "-", "-", "-", "-", "-"]
            ],
            "direction": "right"
        },
        {
            "mapdata": [
                ["-", "-", "-", "-", "-", "-", "-", "-", "-", "-"],
                ["-", "-", "-", "-", "-", "-", "-", "-", "-", "-"],
                ["-", "-", "-", "-", "#", "#", "#", "-", "-", "-"],
                ["-", "-", "-", "#", "#", "I", "#", "#", "#", "-"],
                ["-", "-", "#", "#", ",", ",", ",", ",", "#", "-"],
                ["-", "#", "#", ",", ",", ",", "B", "P", "#", "-"],
                ["-", "#", ",", ",", ",", "#", ",", ",", "#", "-"],
                ["-", "#", ",", ",", ",", ",", ",", "#", "#", "-"],
                ["-", "#", "#", "#", "#", "#", "#", "#", "-", "-"],
                ["-", "-", "-", "-", "-", "-", "-", "-", "-", "-"]
            ],
            "direction": "down"
        },
        {
            "mapdata": [
                ["-", "-", "-", "-", "-", "-", "-", "-", "-", "-"],
                ["-", "-", "-", "-", "-", "-", "-", "-", "-", "-"],
                ["-", "-", "-", "-", "#", "#", "#", "-", "-", "-"],
                ["-", "-", "-", "#", "#", "I", "#", "#", "#", "-"],
                ["-", "-", "#", "#", ",", ",", ",", ",", "#", "-"],
                ["-", "#", "#", ",", ",", ",", "B", ",", "#", "-"],
                ["-", "#", ",", ",", ",", "#", ",", "P", "#", "-"],
                ["-", "#", ",", ",", ",", ",", ",", "#", "#", "-"],
                ["-", "#", "#", "#", "#", "#", "#", "#", "-", "-"],
                ["-", "-", "-", "-", "-", "-", "-", "-", "-", "-"]
            ],
            "direction": "down"
        },
        {
            "mapdata": [
                ["-", "-", "-", "-", "-", "-", "-", "-", "-", "-"],
                ["-", "-", "-", "-", "-", "-", "-", "-", "-", "-"],
                ["-", "-", "-", "-", "#", "#", "#", "-", "-", "-"],
                ["-", "-", "-", "#", "#", "I", "#", "#", "#", "-"],
                ["-", "-", "#", "#", ",", ",", ",", ",", "#", "-"],
                ["-", "#", "#", ",", ",", ",", "B", ",", "#", "-"],
                ["-", "#", ",", ",", ",", "#", "P", ",", "#", "-"],
                ["-", "#", ",", ",", ",", ",", ",", "#", "#", "-"],
                ["-", "#", "#", "#", "#", "#", "#", "#", "-", "-"],
                ["-", "-", "-", "-", "-", "-", "-", "-", "-", "-"]
            ],
            "direction": "left"
        },
        {
            "mapdata": [
                ["-", "-", "-", "-", "-", "-", "-", "-", "-", "-"],
                ["-", "-", "-", "-", "-", "-", "-", "-", "-", "-"],
                ["-", "-", "-", "-", "#", "#", "#", "-", "-", "-"],
                ["-", "-", "-", "#", "#", "I", "#", "#", "#", "-"],
                ["-", "-", "#", "#", ",", ",", "B", ",", "#", "-"],
                ["-", "#", "#", ",", ",", ",", "P", ",", "#", "-"],
                ["-", "#", ",", ",", ",", "#", ",", ",", "#", "-"],
                ["-", "#", ",", ",", ",", ",", ",", "#", "#", "-"],
                ["-", "#", "#", "#", "#", "#", "#", "#", "-", "-"],
                ["-", "-", "-", "-", "-", "-", "-", "-", "-", "-"]
            ],
            "direction": "up"
        },
        {
            "mapdata": [
                ["-", "-", "-", "-", "-", "-", "-", "-", "-", "-"],
                ["-", "-", "-", "-", "-", "-", "-", "-", "-", "-"],
                ["-", "-", "-", "-", "#", "#", "#", "-", "-", "-"],
                ["-", "-", "-", "#", "#", "I", "#", "#", "#", "-"],
                ["-", "-", "#", "#", ",", ",", "B", ",", "#", "-"],
                ["-", "#", "#", ",", ",", ",", ",", "P", "#", "-"],
                ["-", "#", ",", ",", ",", "#", ",", ",", "#", "-"],
                ["-", "#", ",", ",", ",", ",", ",", "#", "#", "-"],
                ["-", "#", "#", "#", "#", "#", "#", "#", "-", "-"],
                ["-", "-", "-", "-", "-", "-", "-", "-", "-", "-"]
            ],
            "direction": "right"
        },
        {
            "mapdata": [
                ["-", "-", "-", "-", "-", "-", "-", "-", "-", "-"],
                ["-", "-", "-", "-", "-", "-", "-", "-", "-", "-"],
                ["-", "-", "-", "-", "#", "#", "#", "-", "-", "-"],
                ["-", "-", "-", "#", "#", "I", "#", "#", "#", "-"],
                ["-", "-", "#", "#", ",", ",", "B", "P", "#", "-"],
                ["-", "#", "#", ",", ",", ",", ",", ",", "#", "-"],
                ["-", "#", ",", ",", ",", "#", ",", ",", "#", "-"],
                ["-", "#", ",", ",", ",", ",", ",", "#", "#", "-"],
                ["-", "#", "#", "#", "#", "#", "#", "#", "-", "-"],
                ["-", "-", "-", "-", "-", "-", "-", "-", "-", "-"]
            ],
            "direction": "up"
        },
        {
            "mapdata": [
                ["-", "-", "-", "-", "-", "-", "-", "-", "-", "-"],
                ["-", "-", "-", "-", "-", "-", "-", "-", "-", "-"],
                ["-", "-", "-", "-", "#", "#", "#", "-", "-", "-"],
                ["-", "-", "-", "#", "#", "I", "#", "#", "#", "-"],
                ["-", "-", "#", "#", ",", "B", "P", ",", "#", "-"],
                ["-", "#", "#", ",", ",", ",", ",", ",", "#", "-"],
                ["-", "#", ",", ",", ",", "#", ",", ",", "#", "-"],
                ["-", "#", ",", ",", ",", ",", ",", "#", "#", "-"],
                ["-", "#", "#", "#", "#", "#", "#", "#", "-", "-"],
                ["-", "-", "-", "-", "-", "-", "-", "-", "-", "-"]
            ],
            "direction": "left"
        },
        {
            "mapdata": [
                ["-", "-", "-", "-", "-", "-", "-", "-", "-", "-"],
                ["-", "-", "-", "-", "-", "-", "-", "-", "-", "-"],
                ["-", "-", "-", "-", "#", "#", "#", "-", "-", "-"],
                ["-", "-", "-", "#", "#", "I", "#", "#", "#", "-"],
                ["-", "-", "#", "#", ",", "B", ",", ",", "#", "-"],
                ["-", "#", "#", ",", ",", ",", "P", ",", "#", "-"],
                ["-", "#", ",", ",", ",", "#", ",", ",", "#", "-"],
                ["-", "#", ",", ",", ",", ",", ",", "#", "#", "-"],
                ["-", "#", "#", "#", "#", "#", "#", "#", "-", "-"],
                ["-", "-", "-", "-", "-", "-", "-", "-", "-", "-"]
            ],
            "direction": "down"
        }
    ]
}
