{
    "mapdata": [
        ["-", "-", "-", "-", "-", "-", "-", "-", "-", "-"],
        ["-", "-", "-", "-", "-", "-", "-", "-", "-", "-"],
        ["-", "-", "#", "#", "#", "-", "-", "-", "-", "-"],
        ["-", "-", "#", "I", "#", "#", "#", "#", "-", "-"],
        ["#", "#", "#", ",", ",", ",", "I", "#", "#", "#"],
        ["#", ",", ",", ",", ",", "B", "B", ",", ",", "#"],
        ["#", ",", "B", ",", ",", ",", ",", ",", "I", "#"],
        ["#", ",", "P", ",", "#", "#", "#", "#", "#", "#"],
        ["#", "#", "#", "#", "#", "-", "-", "-", "-", "-"],
        ["-", "-", "-", "-", "-", "-", "-", "-", "-", "-"]
    ],
    "solution":[
        {
          "mapdata": [
            ["-", "-", "-", "-", "-", "-", "-", "-", "-", "-"],
            ["-", "-", "-", "-", "-", "-", "-", "-", "-", "-"],
            ["-", "-", "#", "#", "#", "-", "-", "-", "-", "-"],
            ["-", "-", "#", "I", "#", "#", "#", "#", "-", "-"],
            ["#", "#", "#", ",", ",", ",", "I", "#", "#", "#"],
            ["#", ",", "B", ",", ",", "B", "B", ",", ",", "#"],
            ["#", ",", "P", ",", ",", ",", ",", ",", "I", "#"],
            ["#", ",", ",", ",", "#", "#", "#", "#", "#", "#"],
            ["#", "#", "#", "#", "#", "-", "-", "-", "-", "-"],
            ["-", "-", "-", "-", "-", "-", "-", "-", "-", "-"]
          ],
          "direction": "up"
        },
        {
          "mapdata": [
            ["-", "-", "-", "-", "-", "-", "-", "-", "-", "-"],
            ["-", "-", "-", "-", "-", "-", "-", "-", "-", "-"],
            ["-", "-", "#", "#", "#", "-", "-", "-", "-", "-"],
            ["-", "-", "#", "I", "#", "#", "#", "#", "-", "-"],
            ["#", "#", "#", ",", ",", ",", "I", "#", "#", "#"],
            ["#", ",", "B", ",", ",", "B", "B", ",", ",", "#"],
            ["#", "P", ",", ",", ",", ",", ",", ",", "I", "#"],
            ["#", ",", ",", ",", "#", "#", "#", "#", "#", "#"],
            ["#", "#", "#", "#", "#", "-", "-", "-", "-", "-"],
            ["-", "-", "-", "-", "-", "-", "-", "-", "-", "-"]
          ],
          "direction": "left"
        },
        {
          "mapdata": [
            ["-", "-", "-", "-", "-", "-", "-", "-", "-", "-"],
            ["-", "-", "-", "-", "-", "-", "-", "-", "-", "-"],
            ["-", "-", "#", "#", "#", "-", "-", "-", "-", "-"],
            ["-", "-", "#", "I", "#", "#", "#", "#", "-", "-"],
            ["#", "#", "#", ",", ",", ",", "I", "#", "#", "#"],
            ["#", "P", "B", ",", ",", "B", "B", ",", ",", "#"],
            ["#", ",", ",", ",", ",", ",", ",", ",", "I", "#"],
            ["#", ",", ",", ",", "#", "#", "#", "#", "#", "#"],
            ["#", "#", "#", "#", "#", "-", "-", "-", "-", "-"],
            ["-", "-", "-", "-", "-", "-", "-", "-", "-", "-"]
          ],
          "direction": "up"
        },
        {
          "mapdata": [
            ["-", "-", "-", "-", "-", "-", "-", "-", "-", "-"],
            ["-", "-", "-", "-", "-", "-", "-", "-", "-", "-"],
            ["-", "-", "#", "#", "#", "-", "-", "-", "-", "-"],
            ["-", "-", "#", "I", "#", "#", "#", "#", "-", "-"],
            ["#", "#", "#", ",", ",", ",", "I", "#", "#", "#"],
            ["#", ",", "P", "B", ",", "B", "B", ",", ",", "#"],
            ["#", ",", ",", ",", ",", ",", ",", ",", "I", "#"],
            ["#", ",", ",", ",", "#", "#", "#", "#", "#", "#"],
            ["#", "#", "#", "#", "#", "-", "-", "-", "-", "-"],
            ["-", "-", "-", "-", "-", "-", "-", "-", "-", "-"]
          ],
          "direction": "right"
        },
        {
          "mapdata": [
            ["-", "-", "-", "-", "-", "-", "-", "-", "-", "-"],
            ["-", "-", "-", "-", "-", "-", "-", "-", "-", "-"],
            ["-", "-", "#", "#", "#", "-", "-", "-", "-", "-"],
            ["-", "-", "#", "I", "#", "#", "#", "#", "-", "-"],
            ["#", "#", "#", ",", ",", ",", "I", "#", "#", "#"],
            ["#", ",", ",", "B", ",", "B", "B", ",", ",", "#"],
            ["#", ",", "P", ",", ",", ",", ",", ",", "I", "#"],
            ["#", ",", ",", ",", "#", "#", "#", "#", "#", "#"],
            ["#", "#", "#", "#", "#", "-", "-", "-", "-", "-"],
            ["-", "-", "-", "-", "-", "-", "-", "-", "-", "-"]
          ],
          "direction": "down"
        },
        {
          "mapdata": [
            ["-", "-", "-", "-", "-", "-", "-", "-", "-", "-"],
            ["-", "-", "-", "-", "-", "-", "-", "-", "-", "-"],
            ["-", "-", "#", "#", "#", "-", "-", "-", "-", "-"],
            ["-", "-", "#", "I", "#", "#", "#", "#", "-", "-"],
            ["#", "#", "#", ",", ",", ",", "I", "#", "#", "#"],
            ["#", ",", ",", "B", ",", "B", "B", ",", ",", "#"],
            ["#", ",", ",", "P", ",", ",", ",", ",", "I", "#"],
            ["#", ",", ",", ",", "#", "#", "#", "#", "#", "#"],
            ["#", "#", "#", "#", "#", "-", "-", "-", "-", "-"],
            ["-", "-", "-", "-", "-", "-", "-", "-", "-", "-"]
          ],
          "direction": "right"
        },
        {
          "mapdata": [
            ["-", "-", "-", "-", "-", "-", "-", "-", "-", "-"],
            ["-", "-", "-", "-", "-", "-", "-", "-", "-", "-"],
            ["-", "-", "#", "#", "#", "-", "-", "-", "-", "-"],
            ["-", "-", "#", "I", "#", "#", "#", "#", "-", "-"],
            ["#", "#", "#", "B", ",", ",", "I", "#", "#", "#"],
            ["#", ",", ",", "P", ",", "B", "B", ",", ",", "#"],
            ["#", ",", ",", ",", ",", ",", ",", ",", "I", "#"],
            ["#", ",", ",", ",", "#", "#", "#", "#", "#", "#"],
            ["#", "#", "#", "#", "#", "-", "-", "-", "-", "-"],
            ["-", "-", "-", "-", "-", "-", "-", "-", "-", "-"]
          ],
          "direction": "up"
        },
        {
          "mapdata": [
            ["-", "-", "-", "-", "-", "-", "-", "-", "-", "-"],
            ["-", "-", "-", "-", "-", "-", "-", "-", "-", "-"],
            ["-", "-", "#", "#", "#", "-", "-", "-", "-", "-"],
            ["-", "-", "#", "B", "#", "#", "#", "#", "-", "-"],
            ["#", "#", "#", "P", ",", ",", "I", "#", "#", "#"],
            ["#", ",", ",", ",", ",", "B", "B", ",", ",", "#"],
            ["#", ",", ",", ",", ",", ",", ",", ",", "I", "#"],
            ["#", ",", ",", ",", "#", "#", "#", "#", "#", "#"],
            ["#", "#", "#", "#", "#", "-", "-", "-", "-", "-"],
            ["-", "-", "-", "-", "-", "-", "-", "-", "-", "-"]
          ],
          "direction": "up"
        },
        {
          "mapdata": [
            ["-", "-", "-", "-", "-", "-", "-", "-", "-", "-"],
            ["-", "-", "-", "-", "-", "-", "-", "-", "-", "-"],
            ["-", "-", "#", "#", "#", "-", "-", "-", "-", "-"],
            ["-", "-", "#", "B", "#", "#", "#", "#", "-", "-"],
            ["#", "#", "#", ",", "P", ",", "I", "#", "#", "#"],
            ["#", ",", ",", ",", ",", "B", "B", ",", ",", "#"],
            ["#", ",", ",", ",", ",", ",", ",", ",", "I", "#"],
            ["#", ",", ",", ",", "#", "#", "#", "#", "#", "#"],
            ["#", "#", "#", "#", "#", "-", "-", "-", "-", "-"],
            ["-", "-", "-", "-", "-", "-", "-", "-", "-", "-"]
          ],
          "direction": "right"
        },
        {
          "mapdata": [
            ["-", "-", "-", "-", "-", "-", "-", "-", "-", "-"],
            ["-", "-", "-", "-", "-", "-", "-", "-", "-", "-"],
            ["-", "-", "#", "#", "#", "-", "-", "-", "-", "-"],
            ["-", "-", "#", "B", "#", "#", "#", "#", "-", "-"],
            ["#", "#", "#", ",", ",", "P", "I", "#", "#", "#"],
            ["#", ",", ",", ",", ",", "B", "B", ",", ",", "#"],
            ["#", ",", ",", ",", ",", ",", ",", ",", "I", "#"],
            ["#", ",", ",", ",", "#", "#", "#", "#", "#", "#"],
            ["#", "#", "#", "#", "#", "-", "-", "-", "-", "-"],
            ["-", "-", "-", "-", "-", "-", "-", "-", "-", "-"]
          ],
          "direction": "right"
        },
        {
          "mapdata": [
            ["-", "-", "-", "-", "-", "-", "-", "-", "-", "-"],
            ["-", "-", "-", "-", "-", "-", "-", "-", "-", "-"],
            ["-", "-", "#", "#", "#", "-", "-", "-", "-", "-"],
            ["-", "-", "#", "B", "#", "#", "#", "#", "-", "-"],
            ["#", "#", "#", ",", ",", ",", "I", "#", "#", "#"],
            ["#", ",", ",", ",", ",", "P", "B", ",", ",", "#"],
            ["#", ",", ",", ",", ",", "B", ",", ",", "I", "#"],
            ["#", ",", ",", ",", "#", "#", "#", "#", "#", "#"],
            ["#", "#", "#", "#", "#", "-", "-", "-", "-", "-"],
            ["-", "-", "-", "-", "-", "-", "-", "-", "-", "-"]
          ],
          "direction": "down"
        },
        {
          "mapdata": [
            ["-", "-", "-", "-", "-", "-", "-", "-", "-", "-"],
            ["-", "-", "-", "-", "-", "-", "-", "-", "-", "-"],
            ["-", "-", "#", "#", "#", "-", "-", "-", "-", "-"],
            ["-", "-", "#", "B", "#", "#", "#", "#", "-", "-"],
            ["#", "#", "#", ",", ",", ",", "I", "#", "#", "#"],
            ["#", ",", ",", ",", "P", ",", "B", ",", ",", "#"],
            ["#", ",", ",", ",", ",", "B", ",", ",", "I", "#"],
            ["#", ",", ",", ",", "#", "#", "#", "#", "#", "#"],
            ["#", "#", "#", "#", "#", "-", "-", "-", "-", "-"],
            ["-", "-", "-", "-", "-", "-", "-", "-", "-", "-"]
          ],
          "direction": "left"
        },
        {
          "mapdata": [
            ["-", "-", "-", "-", "-", "-", "-", "-", "-", "-"],
            ["-", "-", "-", "-", "-", "-", "-", "-", "-", "-"],
            ["-", "-", "#", "#", "#", "-", "-", "-", "-", "-"],
            ["-", "-", "#", "B", "#", "#", "#", "#", "-", "-"],
            ["#", "#", "#", ",", ",", ",", "I", "#", "#", "#"],
            ["#", ",", ",", ",", ",", ",", "B", ",", ",", "#"],
            ["#", ",", ",", ",", "P", "B", ",", ",", "I", "#"],
            ["#", ",", ",", ",", "#", "#", "#", "#", "#", "#"],
            ["#", "#", "#", "#", "#", "-", "-", "-", "-", "-"],
            ["-", "-", "-", "-", "-", "-", "-", "-", "-", "-"]
          ],
          "direction": "down"
        },
        {
          "mapdata": [
            ["-", "-", "-", "-", "-", "-", "-", "-", "-", "-"],
            ["-", "-", "-", "-", "-", "-", "-", "-", "-", "-"],
            ["-", "-", "#", "#", "#", "-", "-", "-", "-", "-"],
            ["-", "-", "#", "B", "#", "#", "#", "#", "-", "-"],
            ["#", "#", "#", ",", ",", ",", "I", "#", "#", "#"],
            ["#", ",", ",", ",", ",", ",", "B", ",", ",", "#"],
            ["#", ",", ",", ",", ",", "P", "B", ",", "I", "#"],
            ["#", ",", ",", ",", "#", "#", "#", "#", "#", "#"],
            ["#", "#", "#", "#", "#", "-", "-", "-", "-", "-"],
            ["-", "-", "-", "-", "-", "-", "-", "-", "-", "-"]
          ],
          "direction": "right"
        },
        {
          "mapdata": [
            ["-", "-", "-", "-", "-", "-", "-", "-", "-", "-"],
            ["-", "-", "-", "-", "-", "-", "-", "-", "-", "-"],
            ["-", "-", "#", "#", "#", "-", "-", "-", "-", "-"],
            ["-", "-", "#", "B", "#", "#", "#", "#", "-", "-"],
            ["#", "#", "#", ",", ",", ",", "I", "#", "#", "#"],
            ["#", ",", ",", ",", ",", ",", "B", ",", ",", "#"],
            ["#", ",", ",", ",", ",", ",", "P", "B", "I", "#"],
            ["#", ",", ",", ",", "#", "#", "#", "#", "#", "#"],
            ["#", "#", "#", "#", "#", "-", "-", "-", "-", "-"],
            ["-", "-", "-", "-", "-", "-", "-", "-", "-", "-"]
          ],
          "direction": "right"
        },
        {
          "mapdata": [
            ["-", "-", "-", "-", "-", "-", "-", "-", "-", "-"],
            ["-", "-", "-", "-", "-", "-", "-", "-", "-", "-"],
            ["-", "-", "#", "#", "#", "-", "-", "-", "-", "-"],
            ["-", "-", "#", "B", "#", "#", "#", "#", "-", "-"],
            ["#", "#", "#", ",", ",", ",", "I", "#", "#", "#"],
            ["#", ",", ",", ",", ",", ",", "B", ",", ",", "#"],
            ["#", ",", ",", ",", ",", ",", ",", "P", "B", "#"],
            ["#", ",", ",", ",", "#", "#", "#", "#", "#", "#"],
            ["#", "#", "#", "#", "#", "-", "-", "-", "-", "-"],
            ["-", "-", "-", "-", "-", "-", "-", "-", "-", "-"]
          ],
          "direction": "right"
        },
        {
          "mapdata": [
            ["-", "-", "-", "-", "-", "-", "-", "-", "-", "-"],
            ["-", "-", "-", "-", "-", "-", "-", "-", "-", "-"],
            ["-", "-", "#", "#", "#", "-", "-", "-", "-", "-"],
            ["-", "-", "#", "B", "#", "#", "#", "#", "-", "-"],
            ["#", "#", "#", ",", ",", ",", "I", "#", "#", "#"],
            ["#", ",", ",", ",", ",", ",", "B", ",", ",", "#"],
            ["#", ",", ",", ",", ",", ",", "P", ",", "B", "#"],
            ["#", ",", ",", ",", "#", "#", "#", "#", "#", "#"],
            ["#", "#", "#", "#", "#", "-", "-", "-", "-", "-"],
            ["-", "-", "-", "-", "-", "-", "-", "-", "-", "-"]
          ],
          "direction": "left"
        },
        {
          "mapdata": [
            ["-", "-", "-", "-", "-", "-", "-", "-", "-", "-"],
            ["-", "-", "-", "-", "-", "-", "-", "-", "-", "-"],
            ["-", "-", "#", "#", "#", "-", "-", "-", "-", "-"],
            ["-", "-", "#", "B", "#", "#", "#", "#", "-", "-"],
            ["#", "#", "#", ",", ",", ",", "B", "#", "#", "#"],
            ["#", ",", ",", ",", ",", ",", "P", ",", ",", "#"],
            ["#", ",", ",", ",", ",", ",", ",", ",", "B", "#"],
            ["#", ",", ",", ",", "#", "#", "#", "#", "#", "#"],
            ["#", "#", "#", "#", "#", "-", "-", "-", "-", "-"],
            ["-", "-", "-", "-", "-", "-", "-", "-", "-", "-"]
          ],
          "direction": "up"
        }
      ]      
}
