{
	"mapdata": [
		["-", "-", "-", "-", "-", "-", "-", "-", "-", "-"],
		["-", "-", "-", "-", "#", "#", "#", "#", "#", "-"],
		["#", "#", "#", "#", "#", ",", ",", "P", "#", "-"],
		["#", ",", "B", ",", ",", ",", ",", ",", "#", "-"],
		["#", "I", ",", ",", ",", "#", ",", "#", "#", "-"],
		["#", "#", "#", ",", ",", ",", ",", "#", "#", "-"],
		["-", "-", "#", ",", ",", ",", ",", ",", "#", "-"],
		["-", "-", "#", "#", "#", ",", "#", ",", "#", "-"],
		["-", "-", "-", "-", "#", ",", ",", ",", "#", "-"],
		["-", "-", "-", "-", "#", "#", "#", "#", "#", "-"]
	],
	"solution": [
    ]

}
