{
    "mapdata": [
        ["-", "-", "-", "-", "-", "-", "-", "-", "-", "-"],
        ["-", "-", "#", "#", "#", "#", "#", "-", "-", "-"],
        ["-", "-", "#", "I", ",", ",", "#", "-", "-", "-"],
        ["-", "-", "#", "#", "I", ",", "#", "#", "-", "-"],
        ["-", "-", "#", "#", ",", "B", ",", "#", "-", "-"],
        ["-", "-", "#", ",", "B", "#", ",", "#", "-", "-"],
        ["-", "-", "#", ",", ",", ",", "P", "#", "-", "-"],
        ["-", "-", "#", "#", "#", "#", "#", "#", "-", "-"],
        ["-", "-", "-", "-", "-", "-", "-", "-", "-", "-"],
        ["-", "-", "-", "-", "-", "-", "-", "-", "-", "-"]
    ],
    "solution": [
        {
            "mapdata": [
                ["-", "-", "-", "-", "-", "-", "-", "-", "-", "-"],
                ["-", "-", "#", "#", "#", "#", "#", "-", "-", "-"],
                ["-", "-", "#", "I", ",", ",", "#", "-", "-", "-"],
                ["-", "-", "#", "#", "I", ",", "#", "#", "-", "-"],
                ["-", "-", "#", "#", ",", "B", ",", "#", "-", "-"],
                ["-", "-", "#", ",", "B", "#", ",", "#", "-", "-"],
                ["-", "-", "#", ",", ",", "P", ",", "#", "-", "-"],
                ["-", "-", "#", "#", "#", "#", "#", "#", "-", "-"],
                ["-", "-", "-", "-", "-", "-", "-", "-", "-", "-"],
                ["-", "-", "-", "-", "-", "-", "-", "-", "-", "-"]
            ],
            "direction": "left"
        },
        {
            "mapdata": [
                ["-", "-", "-", "-", "-", "-", "-", "-", "-", "-"],
                ["-", "-", "#", "#", "#", "#", "#", "-", "-", "-"],
                ["-", "-", "#", "I", ",", ",", "#", "-", "-", "-"],
                ["-", "-", "#", "#", "I", ",", "#", "#", "-", "-"],
                ["-", "-", "#", "#", ",", "B", ",", "#", "-", "-"],
                ["-", "-", "#", ",", "B", "#", ",", "#", "-", "-"],
                ["-", "-", "#", ",", "P", ",", ",", "#", "-", "-"],
                ["-", "-", "#", "#", "#", "#", "#", "#", "-", "-"],
                ["-", "-", "-", "-", "-", "-", "-", "-", "-", "-"],
                ["-", "-", "-", "-", "-", "-", "-", "-", "-", "-"]
            ],
            "direction": "left"
        },
        {
            "mapdata": [
                ["-", "-", "-", "-", "-", "-", "-", "-", "-", "-"],
                ["-", "-", "#", "#", "#", "#", "#", "-", "-", "-"],
                ["-", "-", "#", "I", ",", ",", "#", "-", "-", "-"],
                ["-", "-", "#", "#", "I", ",", "#", "#", "-", "-"],
                ["-", "-", "#", "#", "B", "B", ",", "#", "-", "-"],
                ["-", "-", "#", ",", "P", "#", ",", "#", "-", "-"],
                ["-", "-", "#", ",", ",", ",", ",", "#", "-", "-"],
                ["-", "-", "#", "#", "#", "#", "#", "#", "-", "-"],
                ["-", "-", "-", "-", "-", "-", "-", "-", "-", "-"],
                ["-", "-", "-", "-", "-", "-", "-", "-", "-", "-"]
            ],
            "direction": "up"
        },
        {
            "mapdata": [
                ["-", "-", "-", "-", "-", "-", "-", "-", "-", "-"],
                ["-", "-", "#", "#", "#", "#", "#", "-", "-", "-"],
                ["-", "-", "#", "I", ",", ",", "#", "-", "-", "-"],
                ["-", "-", "#", "#", "B", ",", "#", "#", "-", "-"],
                ["-", "-", "#", "#", "P", "B", ",", "#", "-", "-"],
                ["-", "-", "#", ",", ",", "#", ",", "#", "-", "-"],
                ["-", "-", "#", ",", ",", ",", ",", "#", "-", "-"],
                ["-", "-", "#", "#", "#", "#", "#", "#", "-", "-"],
                ["-", "-", "-", "-", "-", "-", "-", "-", "-", "-"],
                ["-", "-", "-", "-", "-", "-", "-", "-", "-", "-"]
            ],
            "direction": "up"
        },
        {
            "mapdata": [
                ["-", "-", "-", "-", "-", "-", "-", "-", "-", "-"],
                ["-", "-", "#", "#", "#", "#", "#", "-", "-", "-"],
                ["-", "-", "#", "I", "B", ",", "#", "-", "-", "-"],
                ["-", "-", "#", "#", "P", ",", "#", "#", "-", "-"],
                ["-", "-", "#", "#", ",", "B", ",", "#", "-", "-"],
                ["-", "-", "#", ",", ",", "#", ",", "#", "-", "-"],
                ["-", "-", "#", ",", ",", ",", ",", "#", "-", "-"],
                ["-", "-", "#", "#", "#", "#", "#", "#", "-", "-"],
                ["-", "-", "-", "-", "-", "-", "-", "-", "-", "-"],
                ["-", "-", "-", "-", "-", "-", "-", "-", "-", "-"]
            ],
            "direction": "up"
        },
        {
            "mapdata": [
                ["-", "-", "-", "-", "-", "-", "-", "-", "-", "-"],
                ["-", "-", "#", "#", "#", "#", "#", "-", "-", "-"],
                ["-", "-", "#", "I", "B", ",", "#", "-", "-", "-"],
                ["-", "-", "#", "#", "I", "P", "#", "#", "-", "-"],
                ["-", "-", "#", "#", ",", "B", ",", "#", "-", "-"],
                ["-", "-", "#", ",", ",", "#", ",", "#", "-", "-"],
                ["-", "-", "#", ",", ",", ",", ",", "#", "-", "-"],
                ["-", "-", "#", "#", "#", "#", "#", "#", "-", "-"],
                ["-", "-", "-", "-", "-", "-", "-", "-", "-", "-"],
                ["-", "-", "-", "-", "-", "-", "-", "-", "-", "-"]
            ],
            "direction": "right"
        },
        {
            "mapdata": [
                ["-", "-", "-", "-", "-", "-", "-", "-", "-", "-"],
                ["-", "-", "#", "#", "#", "#", "#", "-", "-", "-"],
                ["-", "-", "#", "I", "B", "P", "#", "-", "-", "-"],
                ["-", "-", "#", "#", "I", ",", "#", "#", "-", "-"],
                ["-", "-", "#", "#", ",", "B", ",", "#", "-", "-"],
                ["-", "-", "#", ",", ",", "#", ",", "#", "-", "-"],
                ["-", "-", "#", ",", ",", ",", ",", "#", "-", "-"],
                ["-", "-", "#", "#", "#", "#", "#", "#", "-", "-"],
                ["-", "-", "-", "-", "-", "-", "-", "-", "-", "-"],
                ["-", "-", "-", "-", "-", "-", "-", "-", "-", "-"]
            ],
            "direction": "up"
        },
        {
            "mapdata": [
                ["-", "-", "-", "-", "-", "-", "-", "-", "-", "-"],
                ["-", "-", "#", "#", "#", "#", "#", "-", "-", "-"],
                ["-", "-", "#", "B", "P", ",", "#", "-", "-", "-"],
                ["-", "-", "#", "#", "I", ",", "#", "#", "-", "-"],
                ["-", "-", "#", "#", ",", "B", ",", "#", "-", "-"],
                ["-", "-", "#", ",", ",", "#", ",", "#", "-", "-"],
                ["-", "-", "#", ",", ",", ",", ",", "#", "-", "-"],
                ["-", "-", "#", "#", "#", "#", "#", "#", "-", "-"],
                ["-", "-", "-", "-", "-", "-", "-", "-", "-", "-"],
                ["-", "-", "-", "-", "-", "-", "-", "-", "-", "-"]
            ],
            "direction": "left"
        },
        {
            "mapdata": [
                ["-", "-", "-", "-", "-", "-", "-", "-", "-", "-"],
                ["-", "-", "#", "#", "#", "#", "#", "-", "-", "-"],
                ["-", "-", "#", "B", ",", ",", "#", "-", "-", "-"],
                ["-", "-", "#", "#", "P", ",", "#", "#", "-", "-"],
                ["-", "-", "#", "#", ",", "B", ",", "#", "-", "-"],
                ["-", "-", "#", ",", ",", "#", ",", "#", "-", "-"],
                ["-", "-", "#", ",", ",", ",", ",", "#", "-", "-"],
                ["-", "-", "#", "#", "#", "#", "#", "#", "-", "-"],
                ["-", "-", "-", "-", "-", "-", "-", "-", "-", "-"],
                ["-", "-", "-", "-", "-", "-", "-", "-", "-", "-"]
            ],
            "direction": "down"
        },
        {
            "mapdata": [
                ["-", "-", "-", "-", "-", "-", "-", "-", "-", "-"],
                ["-", "-", "#", "#", "#", "#", "#", "-", "-", "-"],
                ["-", "-", "#", "B", ",", ",", "#", "-", "-", "-"],
                ["-", "-", "#", "#", "I", ",", "#", "#", "-", "-"],
                ["-", "-", "#", "#", "P", "B", ",", "#", "-", "-"],
                ["-", "-", "#", ",", ",", "#", ",", "#", "-", "-"],
                ["-", "-", "#", ",", ",", ",", ",", "#", "-", "-"],
                ["-", "-", "#", "#", "#", "#", "#", "#", "-", "-"],
                ["-", "-", "-", "-", "-", "-", "-", "-", "-", "-"],
                ["-", "-", "-", "-", "-", "-", "-", "-", "-", "-"]
            ],
            "direction": "down"
        },
        {
            "mapdata": [
                ["-", "-", "-", "-", "-", "-", "-", "-", "-", "-"],
                ["-", "-", "#", "#", "#", "#", "#", "-", "-", "-"],
                ["-", "-", "#", "B", ",", ",", "#", "-", "-", "-"],
                ["-", "-", "#", "#", "I", ",", "#", "#", "-", "-"],
                ["-", "-", "#", "#", ",", "B", ",", "#", "-", "-"],
                ["-", "-", "#", ",", "P", "#", ",", "#", "-", "-"],
                ["-", "-", "#", ",", ",", ",", ",", "#", "-", "-"],
                ["-", "-", "#", "#", "#", "#", "#", "#", "-", "-"],
                ["-", "-", "-", "-", "-", "-", "-", "-", "-", "-"],
                ["-", "-", "-", "-", "-", "-", "-", "-", "-", "-"]
            ],
            "direction": "down"
        },
        {
            "mapdata": [
                ["-", "-", "-", "-", "-", "-", "-", "-", "-", "-"],
                ["-", "-", "#", "#", "#", "#", "#", "-", "-", "-"],
                ["-", "-", "#", "B", ",", ",", "#", "-", "-", "-"],
                ["-", "-", "#", "#", "I", ",", "#", "#", "-", "-"],
                ["-", "-", "#", "#", ",", "B", ",", "#", "-", "-"],
                ["-", "-", "#", ",", ",", "#", ",", "#", "-", "-"],
                ["-", "-", "#", ",", "P", ",", ",", "#", "-", "-"],
                ["-", "-", "#", "#", "#", "#", "#", "#", "-", "-"],
                ["-", "-", "-", "-", "-", "-", "-", "-", "-", "-"],
                ["-", "-", "-", "-", "-", "-", "-", "-", "-", "-"]
            ],
            "direction": "down"
        },
        {
            "mapdata": [
                ["-", "-", "-", "-", "-", "-", "-", "-", "-", "-"],
                ["-", "-", "#", "#", "#", "#", "#", "-", "-", "-"],
                ["-", "-", "#", "B", ",", ",", "#", "-", "-", "-"],
                ["-", "-", "#", "#", "I", ",", "#", "#", "-", "-"],
                ["-", "-", "#", "#", ",", "B", ",", "#", "-", "-"],
                ["-", "-", "#", ",", ",", "#", ",", "#", "-", "-"],
                ["-", "-", "#", ",", ",", "P", ",", "#", "-", "-"],
                ["-", "-", "#", "#", "#", "#", "#", "#", "-", "-"],
                ["-", "-", "-", "-", "-", "-", "-", "-", "-", "-"],
                ["-", "-", "-", "-", "-", "-", "-", "-", "-", "-"]
            ],
            "direction": "right"
        },
        {
            "mapdata": [
                ["-", "-", "-", "-", "-", "-", "-", "-", "-", "-"],
                ["-", "-", "#", "#", "#", "#", "#", "-", "-", "-"],
                ["-", "-", "#", "B", ",", ",", "#", "-", "-", "-"],
                ["-", "-", "#", "#", "I", ",", "#", "#", "-", "-"],
                ["-", "-", "#", "#", ",", "B", ",", "#", "-", "-"],
                ["-", "-", "#", ",", ",", "#", ",", "#", "-", "-"],
                ["-", "-", "#", ",", ",", ",", "P", "#", "-", "-"],
                ["-", "-", "#", "#", "#", "#", "#", "#", "-", "-"],
                ["-", "-", "-", "-", "-", "-", "-", "-", "-", "-"],
                ["-", "-", "-", "-", "-", "-", "-", "-", "-", "-"]
            ],
            "direction": "right"
        },
        {
            "mapdata": [
                ["-", "-", "-", "-", "-", "-", "-", "-", "-", "-"],
                ["-", "-", "#", "#", "#", "#", "#", "-", "-", "-"],
                ["-", "-", "#", "B", ",", ",", "#", "-", "-", "-"],
                ["-", "-", "#", "#", "I", ",", "#", "#", "-", "-"],
                ["-", "-", "#", "#", ",", "B", ",", "#", "-", "-"],
                ["-", "-", "#", ",", ",", "#", "P", "#", "-", "-"],
                ["-", "-", "#", ",", ",", ",", ",", "#", "-", "-"],
                ["-", "-", "#", "#", "#", "#", "#", "#", "-", "-"],
                ["-", "-", "-", "-", "-", "-", "-", "-", "-", "-"],
                ["-", "-", "-", "-", "-", "-", "-", "-", "-", "-"]
            ],
            "direction": "up"
        },
        {
            "mapdata": [
                ["-", "-", "-", "-", "-", "-", "-", "-", "-", "-"],
                ["-", "-", "#", "#", "#", "#", "#", "-", "-", "-"],
                ["-", "-", "#", "B", ",", ",", "#", "-", "-", "-"],
                ["-", "-", "#", "#", "I", ",", "#", "#", "-", "-"],
                ["-", "-", "#", "#", ",", "B", "P", "#", "-", "-"],
                ["-", "-", "#", ",", ",", "#", ",", "#", "-", "-"],
                ["-", "-", "#", ",", ",", ",", ",", "#", "-", "-"],
                ["-", "-", "#", "#", "#", "#", "#", "#", "-", "-"],
                ["-", "-", "-", "-", "-", "-", "-", "-", "-", "-"],
                ["-", "-", "-", "-", "-", "-", "-", "-", "-", "-"]
            ],
            "direction": "up"
        },
        {
            "mapdata": [
                ["-", "-", "-", "-", "-", "-", "-", "-", "-", "-"],
                ["-", "-", "#", "#", "#", "#", "#", "-", "-", "-"],
                ["-", "-", "#", "B", ",", ",", "#", "-", "-", "-"],
                ["-", "-", "#", "#", "I", ",", "#", "#", "-", "-"],
                ["-", "-", "#", "#", "B", "P", ",", "#", "-", "-"],
                ["-", "-", "#", ",", ",", "#", ",", "#", "-", "-"],
                ["-", "-", "#", ",", ",", ",", ",", "#", "-", "-"],
                ["-", "-", "#", "#", "#", "#", "#", "#", "-", "-"],
                ["-", "-", "-", "-", "-", "-", "-", "-", "-", "-"],
                ["-", "-", "-", "-", "-", "-", "-", "-", "-", "-"]
            ],
            "direction": "left"
        },
        {
            "mapdata": [
                ["-", "-", "-", "-", "-", "-", "-", "-", "-", "-"],
                ["-", "-", "#", "#", "#", "#", "#", "-", "-", "-"],
                ["-", "-", "#", "B", ",", ",", "#", "-", "-", "-"],
                ["-", "-", "#", "#", "I", ",", "#", "#", "-", "-"],
                ["-", "-", "#", "#", "B", ",", "P", "#", "-", "-"],
                ["-", "-", "#", ",", ",", "#", ",", "#", "-", "-"],
                ["-", "-", "#", ",", ",", ",", ",", "#", "-", "-"],
                ["-", "-", "#", "#", "#", "#", "#", "#", "-", "-"],
                ["-", "-", "-", "-", "-", "-", "-", "-", "-", "-"],
                ["-", "-", "-", "-", "-", "-", "-", "-", "-", "-"]
            ],
            "direction": "right"
        },
        {
            "mapdata": [
                ["-", "-", "-", "-", "-", "-", "-", "-", "-", "-"],
                ["-", "-", "#", "#", "#", "#", "#", "-", "-", "-"],
                ["-", "-", "#", "B", ",", ",", "#", "-", "-", "-"],
                ["-", "-", "#", "#", "I", ",", "#", "#", "-", "-"],
                ["-", "-", "#", "#", "B", ",", ",", "#", "-", "-"],
                ["-", "-", "#", ",", ",", "#", "P", "#", "-", "-"],
                ["-", "-", "#", ",", ",", ",", ",", "#", "-", "-"],
                ["-", "-", "#", "#", "#", "#", "#", "#", "-", "-"],
                ["-", "-", "-", "-", "-", "-", "-", "-", "-", "-"],
                ["-", "-", "-", "-", "-", "-", "-", "-", "-", "-"]
            ],
            "direction": "down"
        },
        {
            "mapdata": [
                ["-", "-", "-", "-", "-", "-", "-", "-", "-", "-"],
                ["-", "-", "#", "#", "#", "#", "#", "-", "-", "-"],
                ["-", "-", "#", "B", ",", ",", "#", "-", "-", "-"],
                ["-", "-", "#", "#", "I", ",", "#", "#", "-", "-"],
                ["-", "-", "#", "#", "B", ",", ",", "#", "-", "-"],
                ["-", "-", "#", ",", ",", "#", ",", "#", "-", "-"],
                ["-", "-", "#", ",", ",", ",", "P", "#", "-", "-"],
                ["-", "-", "#", "#", "#", "#", "#", "#", "-", "-"],
                ["-", "-", "-", "-", "-", "-", "-", "-", "-", "-"],
                ["-", "-", "-", "-", "-", "-", "-", "-", "-", "-"]
            ],
            "direction": "down"
        },
        {
            "mapdata": [
                ["-", "-", "-", "-", "-", "-", "-", "-", "-", "-"],
                ["-", "-", "#", "#", "#", "#", "#", "-", "-", "-"],
                ["-", "-", "#", "B", ",", ",", "#", "-", "-", "-"],
                ["-", "-", "#", "#", "I", ",", "#", "#", "-", "-"],
                ["-", "-", "#", "#", "B", ",", ",", "#", "-", "-"],
                ["-", "-", "#", ",", ",", "#", ",", "#", "-", "-"],
                ["-", "-", "#", ",", ",", "P", ",", "#", "-", "-"],
                ["-", "-", "#", "#", "#", "#", "#", "#", "-", "-"],
                ["-", "-", "-", "-", "-", "-", "-", "-", "-", "-"],
                ["-", "-", "-", "-", "-", "-", "-", "-", "-", "-"]
            ],
            "direction": "left"
        },
        {
            "mapdata": [
                ["-", "-", "-", "-", "-", "-", "-", "-", "-", "-"],
                ["-", "-", "#", "#", "#", "#", "#", "-", "-", "-"],
                ["-", "-", "#", "B", ",", ",", "#", "-", "-", "-"],
                ["-", "-", "#", "#", "I", ",", "#", "#", "-", "-"],
                ["-", "-", "#", "#", "B", ",", ",", "#", "-", "-"],
                ["-", "-", "#", ",", ",", "#", ",", "#", "-", "-"],
                ["-", "-", "#", ",", "P", ",", ",", "#", "-", "-"],
                ["-", "-", "#", "#", "#", "#", "#", "#", "-", "-"],
                ["-", "-", "-", "-", "-", "-", "-", "-", "-", "-"],
                ["-", "-", "-", "-", "-", "-", "-", "-", "-", "-"]
            ],
            "direction": "left"
        },
        {
            "mapdata": [
                ["-", "-", "-", "-", "-", "-", "-", "-", "-", "-"],
                ["-", "-", "#", "#", "#", "#", "#", "-", "-", "-"],
                ["-", "-", "#", "B", ",", ",", "#", "-", "-", "-"],
                ["-", "-", "#", "#", "I", ",", "#", "#", "-", "-"],
                ["-", "-", "#", "#", "B", ",", ",", "#", "-", "-"],
                ["-", "-", "#", ",", "P", "#", ",", "#", "-", "-"],
                ["-", "-", "#", ",", ",", ",", ",", "#", "-", "-"],
                ["-", "-", "#", "#", "#", "#", "#", "#", "-", "-"],
                ["-", "-", "-", "-", "-", "-", "-", "-", "-", "-"],
                ["-", "-", "-", "-", "-", "-", "-", "-", "-", "-"]
            ],
            "direction": "up"
        },
        {
            "mapdata": [
                ["-", "-", "-", "-", "-", "-", "-", "-", "-", "-"],
                ["-", "-", "#", "#", "#", "#", "#", "-", "-", "-"],
                ["-", "-", "#", "B", ",", ",", "#", "-", "-", "-"],
                ["-", "-", "#", "#", "B", ",", "#", "#", "-", "-"],
                ["-", "-", "#", "#", "P", ",", ",", "#", "-", "-"],
                ["-", "-", "#", ",", ",", "#", ",", "#", "-", "-"],
                ["-", "-", "#", ",", ",", ",", ",", "#", "-", "-"],
                ["-", "-", "#", "#", "#", "#", "#", "#", "-", "-"],
                ["-", "-", "-", "-", "-", "-", "-", "-", "-", "-"],
                ["-", "-", "-", "-", "-", "-", "-", "-", "-", "-"]
            ],
            "direction": "up"
        }
    ]

}
