{
    "mapdata": [
        ["-", "-", "-", "-", "-", "-", "-", "-", "-", "-"],
        ["-", "-", "-", "-", "-", "-", "-", "-", "-", "-"],
        ["-", "-", "#", "#", "#", "#", "#", "-", "-", "-"],
        ["-", "-", "#", "I", ",", ",", "#", "-", "-", "-"],
        ["-", "-", "#", ",", "I", "B", "#", "#", "-", "-"],
        ["-", "-", "#", "P", "B", ",", ",", "#", "-", "-"],
        ["-", "-", "#", "#", ",", ",", ",", "#", "-", "-"],
        ["-", "-", "-", "#", "#", "#", "#", "#", "-", "-"],
        ["-", "-", "-", "-", "-", "-", "-", "-", "-", "-"],
        ["-", "-", "-", "-", "-", "-", "-", "-", "-", "-"]
    ],
    "solution": [
    ]
}
